# Dearborn Speedwriting Vocabulary ---------------- updated 2020.01.29
# Note: Creative Commons NonCommercial 4.0 International License.
# This is the 1930+ version of Emma Dearborn's Speedwriting shorthand.
a = a
a great = agr
a little = all
abandon = ab-n
abbreviation = abvj
ability = b;
able = ab
aboard = ab/
abolition = ablj
abomination = abmj
abortion = abj
about = ab
about the = abt
about the world = abtwo
about these = abtz
above = bv
above all = bvl
abroad = abrd
abrupt = abp
abruptly = abpl
absence = absc/
absent = abs-
absolute = abs
absolutely = absl
absorb = absb
abstain = absn
abstract = abSk
absurd = abs/
abundant = ab--
abuse = abu
academic = akdmk
academy = akdm,
accede = xe
accelerate = Xl;
accent = x-
accept = xep
acceptable = xepb
acceptance = xepc/
access = x'
accessible = xsb
accident = xd-
accidental = xd-l
accomodate = akda
accomodation = akdj
accompany = aco
accomplish = akpZ
accomplishment = akpZ-
according = ak/g
according to = ak/to
account = akt
accountable = aktb
accounting = aktg
accumulate = akla
accuracy = aks,
accurate = ak;
accurately = ak;l
accusation = aksj
accuse = akz
ace = as
ache = ak
achieve = acv
achievement = acv-
acid = acd
acknowledge = ak
acquaint = q-
acquire = aqi
acquisition = aqsj
acre = Ak
across = kr'
act = ak
action = akj
actionable = akjb
active = akv
actively = akvl
activist = akv,
activity = akv;
actor = Ak
actress = Ak'
actual = akl
adapt = adp
add = ad
adder = Ad
addition = adj
additional = adjl
address = ad'
adequate = aqa
adjust = j,
adjustment = j,-
administer = amS
administration = amSj
administrator = amSar
admire = ami
admission = amj
admit = amt
adolescence = adlsc/
adopt = adp
adoption = adpj
adorable = adob
adult = adl
adultery = Adl,
advance = vc/
advancement = vc-
advantage = avj
adventure = av-u
adversity = avs;
advertise = avz
advertiser = Avz
advice = vis
advise = vz
adviser = Vz
advocate = avka
aesthetic = estT
affair = afa
affect = afk
affiliate = afl;
affiliation = aflj
affirm = afm
affirmative = afmv
afford = af/
afraid = fra
after = af
afternoon = afn
afterward = af/
again = ag
again and again = agag
against = ag
age = aj
aged = ajd
agency = aj/
agenda = aj-a
agent = aj-
aggression = Agj
aggressive = Agsv
agile = ajl
ago = ag
agree = Ag
agreement = Ag-
agricultural = Agkl
ah = ah
ahead = ahd
aid = ad
ail = al
aim = am
air = ar
airplane = arpln
airport = arp/
aisle = il
alarm = alm
alarmist = alm,
album = albm
alcohol = alkl
alder = Al
ale = al
alert = al/
algebra = aljbr
alien = aln
alike = alk
alive = alv
alkaline = alkli
all = l
all about = lab
all his = ls
all sorts of = ls//v
allegation = algj
allege = alj
allegedly = aljl
alley = al,
alliance = ali/
alligator = Alga
allow = alw
allude = alu
ally = ali
almanac = lmnk
almond = am-
almost = lmo
alone = alo
along = lg
alongside = lgsi
aloud = alw
alphabet = afbt
already = lr
also = lso
alter = Al
alternate = Alna
alternative = Alnv
although = lto
altitude = altu
altogether = ltog
aluminum = almn
always = lw
always have been = lwvb
always will be = lwlb
am = m
amateur = mtu
amaze = mz
amazing = mzg
ambassador = Mb'
amber = Mb
ambiguity = mbg;
ambiguous = mbgx
ambition = mbj
ambitious = mbjx
amend = am-
amendment = am--
America = Am
American = Am
amid = amd
amity = m;
ammonia = mna
ammunition = mnj
amnesty = mns,
among = mg
amount = amt
amphibious = mfbx
ample = mp
amplifier = Mpf
amplify = mpf
amplitude = mptu
amuse = mz
an = a
an old = aol
anagram = aG
analogy = alj,
analysis = alss
analyst = al,
analyze = alz
anarchist = aak,
anatomical = atmK
ancestor = asS
anchor = Aq
ancient = aj/
and = a
and all = al
and do your = adou
and has = aas
and his = as
and I = ai
and it will = atl
and the = at
and then = atn
and when = awn
and will = al
and you = au
anew = anu
angel = ajl
anger = Ag
angrily = Agl
angry = Ag,
anguish = agZ
animal = aml
animate = ama
ankle = aql
annexation = anxj
anniversary = avsy
annoint = ay-
announce = ac/
announcement = ac-
annoy = ay
annual = aul
anode = ao
anodyne = aodi
anonymous = aomx
another = aO
answer = ans
ant = a-
antagonize = a-gnz
antarctic = a-ak
antelope = a-lp
antenna = a-na
anthology = a-ol
anthropology = atpol
anticipate = a-spa
antique = a-ek
antiseptic = a-spk
anxiety = ax;
anxious = ax
any = n,
any of the = n,vt
anybody = n,bd,
anyone = n,n
anything = n,g
anyway = n,a
anywhere = n,r
apart = ap/
apartment = ap/-
ape = ap
apologize = apolz
apology = apol
apostrophe = apSf
appalling = aplg
apparent = aP-
apparently = aP-l
appeal = apl
appear = ap
appearance = apc/
append = ap-
appendix = ap-x
appetite = apti
apple = ap
appliance = api/
application = apkj
apply = api
appoint = apy
appointment = apy-
appreciate = pZ;
appreciation = pZj
apprehend = aph-
approach = apc
appropriate = app;
approval = pvl
approve = pv
approximate = apx
April = ap
aptitude = aptu
aquarium = aqym
aquatic = aqT
arbitrary = Aby
arbitration = Abj
arch = ac
archaeology = akol
archer = Ac
architect = aktk
architecture = aktku
arctic = aktk
ardor = Ad
are = r
are you = ru
are you going = rug
area = are
aren't = r-
arena = rna
argue = agu
argument = agu-
arise = arz
aristocracy = arsks,
arithmetic = rtmT
arm = am
armistice = amss
armoa = aoma
armor = Am
around = rw
around the world = rwtwo
arrange = rj
arrest = ar,
arrive = rv
arrogant = arg-
arrow = aro
arsenic = asnk
art = a/
artery = a/y
artifact = a/fk
artificial = a/fx
artist = a/,
artistic = a/S
artless = a/l'
as = as
as good as = sgs
as it was = astz
as much as = smcs
as soon as = ssns
as well as = sls
asbestos = asbss
ascend = as-
ash = aZ
ashamed = aZm
ashore = aZo
Asian = aZn
aside = asi
ask = sk
asleep = slp
asparagus = sPgx
aspect = aspk
aspiration = aspj
aspire = aspi
ass = a'
assailant = asal-
assault = aslt
assemble = smb
assert = as/
assess = s'
assessment = ss-
assets = asts
assign = sin
assignment = sin-
assist = as,
assistance = ssc/
assistant = ss-
associate = sZ;
association = sZj
assortment = as/-
assume = asu
assumption = asmj
assure = su
assuredly = sudl
aster = aS
asterisk = aSsk
asteroid = aSy
astonish = stnZ
astounding = stw-g
astrology = aSol
astronomy = aSnm,
asylum = aslm
at = at
at large = atlj
at our = atr
ate = at
atheist = ate,
athlete = atle
athletic = atlT
Atlantic = atN
atmosphere = atmsf
atom = atm
atrocious = Ax
attach = atc
attachment = atc-
attack = atk
attainable = atnb
attempt = atm
attend = at-
attendance = at-c/
attendant = at--
attention = atj
attic = aT
attitude = attu
attorney = An,
attract = Ak
attraction = Akj
attractive = Akv
attribute = Abu
auction = akj
audacious = adx
audible = adb
audience = adc/
audio = ado
August = ag
aunt = a-
auricle = aK
aurora = aora
auspices = aspss
austere = aS
austerity = aS;
authentic = atN
authenticate = atN;
author = A
authoritative = Av
authority = A;
authorize = Az
auto = ato
autograh = atG
automatic = atmT
automobile = atmb
autonomy = atnm
autumn = atm
autumnal = atmnl
available = avlb
avenue = av
average = av
aviation = avj
avoid = avy
avoidable = avyb
await = awa
awake = awk
award = a/
aware = awa
away = awa
awful = af
awoke = awo
axe = ax
axis = xs
axle = xl
azure = az/
baby = bb,
bachelor = Bcl
back = bk
backer = Bk
background = bkgrw
backyard = bky/
bacteria = bktya
bad = bd
badge = bj
badger = Bj
baffle = bfl
bag = bg
baggage = bgj
bail = bal
bait = ba
bake = bak
baker = Bak
balance = bal
ball = bal
ballet = bla
balloon = bln
ballot = blt
bamboo = bmbu
ban = bn
banana = bnna
band = b-
bandage = b-j
bandit = b-t
bang = bg
banish = bnZ
banjo = bjo
bank = bq
banker = Bq
banking = bqg
bankruptcy = bqps,
banner = Bn
banquet = bqt
banter = B-
baptism = bpI
Baptist = bp,
bar = ba
barbarian = bbyn
barber = Bb
bare = ba
bargain = bgn
barium = bym
bark = bak
barley = bl,
barn = ban
barnyard = bny/
barometer = baMe
baron = bao
barrel = brl
barrier = By
barter = B/
base = bs
baseball = bsbl
basement = bs-
basic = bsk
basically = bskl
basin = bsn
basis = bss
basket = bskt
basketball = bsktbl
bastard = bSd
bat = bt
batch = bc
bath = bth
bathroom = btrm
batter = Bt
battery = bty
battle = btl
bay = ba
bazaar = bza
be = b
beach = bc
beam = bm
bean = bn
bear = ba
beard = b/
beast = b,
beat = be
beater = Be
beating = beg
beautiful = btf
beauty = bt,
because = ks
because of the = ksvt
become = bk
bed = bd
bedroom = bdrm
bedtime = bdti
bee = b
beef = bf
been = b
been able to = babt
beet = be
before = bf
before him = bfm
before you = bfu
beg = bg
began = bg
beggar = Bg
begin = bg
behalf = bhf
behave = bhv
behavior = Bhv
behind = bh
being = b
belief = ble
believe = ble
bell = bl
belly = bl,
belong = blg
below = blo
belt = blt
bench = bnc
bend = b-
beneath = bne
benefactor = bFk
beneficial = bfx
beneficiary = bfZ
benefit = bnf
benevolent = bvl-
berry = by
beside = bsi
besides = bsis
best = b,
best of my = b,vmi
bet = bt
betray = Ba
better = B
between = bt
beyond = by
bias = bis
Bible = bib
bibliography = bbG
bicycle = bsK
bid = bd
bide = bi
big = bg
bigger = Bg
bill = bl
billion = bln
bind = bi-
binder = Bi-
binds = bi--
biography = bG
biology = bol
bird = b/
birth = brt
birthday = brtd
bishop = bZp
bit = bt
bite = bi
bitter = Bt
bizarre = bza
black = bl
blackberry = blby
blade = bla
blame = bla
bland = bl-
blank = blq
blanket = blqt
blast = bl,
bleed = ble
blend = bl-
bless = bl'
blesses = bl''
blessing = blsg
blind = bli-
blindly = bli-l
blink = blq
blizzard = blz/
block = blk
blood = bld
bloody = bld,
blouse = blw
blow = blo
blower = Blo
blue = blu
blueberry = bluby
blunder = Bl-
blur = blr
blurred = bl/
board = b/
boast = b,
boat = bo
body = bd,
boil = byl
boiler = Byl
boisterous = bySx
bold = bol
bomb = bm
bomber = Bm
bombing = bmg
bond = b-
bone = bn
bonus = bnx
book = bk
boost = b,
boot = bt
booth = bth
border = B/
bore = bo
born = bn
borrow = bro
borrower = Bro
boss = b'
both = bo
both day and night = bodani
bother = Bo
bottom = btm
bought = bt
boulder = Bol
bounce = bc/
bound = bw
boundary = bwy
bounty = b-,
bow (v.) = bw
bowels = bwls
bowl = bol
box = bx
boxer = Bx
boy = by
boycott = bykt
boyfriend = byfr
boys = bys
brain = brn
branch = brc
brand = br-
brave = brv
bread = brd
break = brk
breaker = Brk
breakfast = bkf,
breast = br,
breath = brt
breathe = brth
breeze = brz
brevity = bv;
brew = bru
brewer = Bru
brick = brk
bride = bri
bridge = brj
brief = brf
bright = bri
brilliant = bl-
brine = brin
bring = br
broad = brd
broadcast = brdk,
broken = brk
broker = Brk
bronze = brnz
brother = Bro
brotherhood = Brohd
brought = bro
brown = bw
bruise = brz
brunt = br-
brush = brZ
brutal = brul
bubble = bb
buck = bk
bucket = bkt
buckle = bK
buddy = bd,
budget = bjt
buffalo = bflo
bug = bg
buggy = bg,
build = bld
builder = Bld
building = bldg
bulb = blb
bulk = blk
bull = bl
bullet = blt
bulletin = bltn
bunch = bnc
burden = b/n
bureau = buo
bureaucracy = buoks,
burial = byl
burn = bn
burner = Bn
burning = bng
burst = br,
bury = by
bus = bs
bushy = bZ,
busier = Bz
busily = bzl
business = bs
busy = bz
but = b
but I think = bitq
but when = bwn
butter = B
butterfly = Bfli
button = btn
buy = b
buyer = B
buzz = bz
by = b
by and by = bb
by no means = bnome
by the = bt
cab = kb
cabbage = kbj
cabin = kbn
cabinet = kbnt
cable = kb
cafe = kfa
cafeteria = kfty
cage = kj
cake = kk
calculate = kkla
calculation = kklj
calendar = Kl-
calf = kf
call = kl
call them = kltm
caller = Kl
calm = km
calves = kvs
came = k
camera = Kma
campaign = kmpn
can = k
can be done = kbdn
can make = kmk
can you do = kudo
can't = k-
canal = knl
cancel = ksl
cancer = Ks
candidate = k-da
candle = k-l
candy = k-,
cannot = kn
canoe = knu
canvas = kvs
cap = kp
capability = kpb;
capable = kpb
capacity = kps;
capital = kptl
capitalism = kptlI
capitol = kptl
capsize = kpsz
capsule = kpsl
captain = cap
captive = kpv
capture = kpu
car = ka
carbohydrate = kbH;
carbon = kbn
card = k/
cardboard = k/b/
cardinal = k/nl
cards = k//
care = ka
career = kre
careful = kaf
careless = ka'
carelessness = ka''
carnival = knvl
carriage = kyj
carrier = Ky
carrot = kat
carry = ky
cart = k/
cartoon = k/n
carve = kv
case = kas
cash = kZ
cashier = kZe
casino = ksno
cast = k,
castle = ksl
casual = kx
casualties = ksx,,
casualty = kxt,
catalog = ktlg
catastrophe = ktSf
catch = kc
catcher = Kc
category = ktgy
cater = Ka
cathedral = ktdrl
cattle = ktl
caught = kt
cauliflower = kflw
causation = ksj
cause = ks
caution = kj
cave = kv
cavity = kv;
cease = ss
ceiling = slg
celebrate = slb;
celebration = slbj
celebrity = slb;
celery = sly
celestial = slsx
cell = sl
cellar = Sl
cement = se-
cemetery = smty
census = scx
cent = c
center = S-
central = S-l
century = s-y
cereal = syl
ceremony = smn,
certain = s/n
certainly not = s/nn
cesspool = sspl
chain = cn
chair = ca
chairman = cam-
challenge = clj
champion = cmp
championship = cmpZ
chance = cc/
chancellor = Ccl
change = cj
chaotic = kT
chapter = Cp
char = cr
character = Kk
charge = cg
charger = Cg
chart = c/
charter = C/
chase = cs
chatter = Ct
chauffeur = Zf
cheap = cp
cheat = ct
check = ck
cheer = ce
cheese = cz
chemical = kmK
chess = c'
chest = c,
chew = cu
chicken = ckn
chief = cf
child = ci
children = cil
chilly = cl,
chin = cn
chocolate = ckla
choice = cy
choose = cz
Christian = krsn
chronicle = knK
chubby = cb,
church = cc
cider = Si
cigarette = Sgt
circle = Cl
circular = Clr
circulate = Cla
circumstance = C,
circumstances = C,,
circumvent = Cv-
cite = si
citizen = stzn
city = s;
civic = svk
civil = svl
civilian = svln
civility = svl;
civilization = svlzj
claim = kla
clarify = klyf
class = kl'
classes = kl''
classification = klsf/
classroom = klsrm
clean = kln
cleaner = Kln
clear = klr
clemency = klmc/
clergy = klj,
clerk = klk
clever = Klv
climate = kli;
clinic = klnk
close (aj.) = kls
close (v.) = klz
clothes = klz
cloud = klw
cloudy = klw,
coach = kc
coast = k,
coconut = kknt
code = ko
coffee = kf,
coil = kyl
coin = ky
cold = kl
colder = Kl
collect = kk
collide = kli
color = Kl
combine = kbi
come = k
come again = kag
come down = kdw
come in = kn
comfort = kf/
command = k-
commander = K-
commemorate = kmra
commendable = k-b
comment = k-
commentary = k-y
commission = kj
commissioner = Kj
committee = k;
commodity = kd;
common = kn
commonly = knl
commonwealth = knwl
communicate = knka
community = kn;
company = ko
compare = kpa
complete = kpe
completion = kpej
compliant = kpi-
comprehensible = kpcb
compromise = kpmz
compute = kpu
computer = Kpu
concert = ks/
concussion = kkj
condition = kdj
conduct = kdk
confer = kf
conference = kfc/
confirm = kfm
confirmation = kfmj
confuse = kfz
congress = kg'
congressional = kgjl
conquer = Kq
conqueror = Kqr
conscientiously = ksnxl
conscious = kx
consent = ks-
consequence = ksqc/
conservative = ksvv
consider = Ks
consist = ks,
constant = ks-
constitution = kstj
constrain = kSn
consume = ksu
consumer = Ksu
contain = ktn
contempt = ktm
content = kt-
contest = kt,
continent = K-
continue = Ku
continuous = Kx
contract = Kk
contrary = Ky
contrast = K,
contribute = Kb
control = Kl
convenient = kvn-
convention = kvj
conversation = kvsj
cook = kk
cooker = Kk
cool = kl
cooler = Kl
cooperate = kop;
copper = Kp
copy = kp,
core = ko
corn = kn
corner = Kn
coroner = Kon
corporation = kpj
correct = krk
correction = krkj
correctly = krkl
correspond = ksp-
correspondent = ksp--
corroborate = kbra
cosmetic = ksmT
cost = k,
cottage = ktj
could = kd
could have been = kdvb
could not be = kdnb
couldn't = kd-
council = ksl
count = kt
country = K
county = kt,
course = krs
court = k/
cover = Kv
cow = kw
crackdown = krkdw
cracker = Kk
crash = krZ
crate = kra
crater = Kra
crayon = krao
crazy = krz,
create = kr;
creator = Kr;
credential = kdx
credit = cr
creditor = Cr
crescent = ks-
criminal = kmnl
crisis = krss
critic = krT
critical = ktK
cross = kr'
crowd = krw
crown = kwn
cry = kri
cuckoo = kku
cucumber = Kkb
culminate = klm;
culture = kltu
cup = kp
cure = ku
curfew = kfu
currency = krc/
custody = ksd,
custom = ksm
customer = Ksm
cut = kt
cute = ku
cutter = Kt
cycle = Sk
cylindrical = Sl-K
daffodil = dfdl
daily = dl
dam = dm
damage = dmj
dance = dc/
dandelion = d-lio
danger = Dj
dangerous = Djx
dark = dk
darkness = dk'
data = dta
date = da
daughter = Da
day = d
day after day = dafd
day and night = dani
daybreak = dbk
daytime = dti
dead = dd
deal = dl
dealer = Dl
dear = de
death = dth
debate = dba
debt = dt
debtor = Dt
decay = dka
deceive = dse
deceiver = Dse
December = dc
decide = dsi
decision = dsj
declare = dc
deduct = ddk
deep = dp
defend = df-
deficient = dfj/
degree = Dg
delay = dla
delete = dle
delight = dli
deliver = dl
democratic = dem
demonstration = dmSj
denounce = dnc/
deny = dni
department = dp-/
departure = dp/u
depend = dp-
dependent = dp--
deport = dp/
depot = dpo
depreciate = dpZ;
descend = ds-
desirable = dsrb
desire = dsr
despise = dspz
despite = dspi
destroy = dSy
destruction = dSkj
detain = dtn
detention = dtj
deteriorate = D;
determine = Dm
dew = du
diagram = dG
diary = dy
dice = dis
dictate = dkta
dictator = Dkta
did = dd
did not = ddn
didn't = dd-
die = di
different = df
difficult = dfk
dilute = dlu
dimension = dmj
dinner = Dn
diplomatic = dpmT
dipper = Dp
direct = drk
direction = drkj
dirt = d/
disagree = dsAg
disaster = dsS
discontinue = dsKu
discover = dsKv
disease = dsz
dish = dZ
dislike = dslk
dismiss = dsm'
dispose = dspz
distance = dsc/
distant = ds-
distress = dS'
distribute = dSbu
district = dSk
ditch = dc
divide = dvi
divinity = dvn;
division = dvj
do = do
do it = dot
do not = don
do not have = donv
do the work = dotwk
do their = dotr
do things = dotgs
do well = dol
do you see = douse
do you think = doutq
do you understand = douUs-
doctor = dr
document = dk-
does = ds
does it = dst
does not = dsn
doesn't = ds-
doll = dl
dollar = Dl
domestic = dmS
don't = do-
double = db
down = dw
downward = dw/
draw = dra
drawer = Dra
drawn = dran
dream = drm
dress = dr'
drink = dq
drinker = Dq
drive = dri
drone = drn
drought = drw
drove = drv
dry = dri
dual = dul
duplicate = dpka
durable = dub
duration = duj
during = du
dwindle = dw-l
each = ec
each other = ecO
eagle = egl
ear = er
early = el
earth = eth
earthquake = ethqk
east = E
easy = ez
eat = et
economic = ekmk
economy = ekm,
edge = ej
education = edkj
eel = el
efficient = fj/
egg = eg
either = E
elaborate = Lb;
elbow = lbo
election = lkj
electric = Elk
electricity = Els;
elegant = elg-
element = el-
elevate = elva
elevator = Elva
elimination = elmj
else = ls
email = eml
embassy = mbs,
embrace = mbrs
emigrant = mg-
emotion = emj
emphasize = mfsz
empire = mpi
employee = mpye
employer = Mpy
enact = nak
enclose = nc
encounter = nK
encourage = nkrj
encrypt = nkrp
end = e-
end of = e-v
ending = e-g
endorse = nds
enemy = nm,
energy = nj,
English = Eg
enjoy = njy
enough = nf
entanglement = ntgl-
enter = N
entertainment = Ntn-
entire = nti
envelope = nvlp
environment = nvrn-
envoy = nvy
epidemic = epdmk
epigram = epG
equal = eq
equality = eq;
equally important = eqip
equinox = eqnx
equipment = qp-
era = era
erode = ero
erotic = erT
error = Er
essay = esa
essential = esx
establish = est
establishment = est-
estimate = esma
eternal = Enl
Europe = Eu
evacuate = vk;
even = vn
evening = eve
evenly = vnl
event = ev-
eventual = ev-l
ever = ev
every = ev
every way = evwa
every year = evy
everyone = evn
everything = evg
everywhere = evr
evidence = vdc/
ewe = u
exact = xk
exactly = xkl
examine = xm
examiner = Xm
example = xmp
exceed = xe
excel = xl
excellent = xl-
except = xep
excessive = xsv
exchange = xcj
exclusive = xksv
executive = xkv
exert = x/
exist = x,
exit = xt
expect = xpk
expense = xpc/
expensive = xpcv
explain = xpn
explore = xpo
explosion = xplj
export = xp/
express = xp
extension = xtj
extinct = xq
extort = xt/
extra = X
extract = Xk
extraordinary = Xy
extreme = Xm
exude = xu
eye = i
eyesight = isi
face = fs
facility = fsl;
fact = fk
faction = fkj
fail = fl
fair = fa
fairer = Fa
family = fml
far = fa
far off = faof
farther = Fa
fast = f,
father = Fa
favorable = fvb
fear = fe
February = fb
feel = fl
fence = fc/
few = fu
field = fel
fight = fi
fill = fl
financial record = fnxrk/
find = fi
finder = Fi
finger = Fg
fire = fr
first = f,
fish = fZ
flash = flZ
flirt = fl/
flood = fld
floor = flo
flour = flw
fly = fli
follow = fo
follower = Fo
foot = ft
for = f
for a new = fanu
for a while = fawl
for a year = fay
for good = fg
for him = fm
for his = fs
for many years = fmys
for me = fme
for more = fmo
for more information = fmonfj
for the = ft
for you = fu
for you before = fubf
force = fs
forecast = fk,
foreign = fn
forest = f,
forever = fv
forget = fgt
forgive = fgi
form = fm
former = Fm
formerly = Fml
forward = f/
found = fw
foundation = fwj
founder = Fw
free = fre
frequent = fq-
Friday = fr
from = fm
from here = fmhe
from home = fmho
front = fr-
fruit = fru
full = fu
fundamental = f--l
funeral = Fnl
furniture = fntu
fusion = fj
future = Fu
futuristic = FuS
gain = gn
game = gm
garden = g/n
gardener = G/n
gateway = gawa
gather = Ga
gay = ga
general = Jnl
gentle = j-l
geographical = jGK
get = gt
get back = gtbk
giant = ji-
gift = gf
ginger = Jnj
girl = gl
give = gi
given = gi
giver = Gi
glad = gl
glad to see = gltse
glass = gl'
go = g
go on = go
go out = gou
go to the = gtot
gone = gn
good = g
good argument = gagu-
good cause = gks
good chance = gcc/
good deal = gdl
good enough = gnf
good experience = gxpc/
good for nothing = gfng
good friend = gfr
good opportunity = gopt
govern = gvn
government = gv-
governor = Gvn
grace = grs
grammatical = GtK
grandfather = g-Fa
grandmother = g-Mo
grant = gr-
graph = G
graphite = Gi
grass = gr'
great = gr
greater = Gr
green = grn
grind = gr-
grinder = Gr-
grocery store = gsyS
ground = grw
grow = gro
grudge = grj
gruel = grul
guard = g/
guess = g'
guilty = glt,
gyrate = jra
habit = hbt
had = h
had been = hb
had his = hs
hadn't = h-
hail = hl
hair = ha
hairy = hy
half = hf
halt = hlt
ham = hm
hammer = Hm
hand = h-
handle = h-l
handsome = h-so
hang = hg
hanger = Hg
happen = hp
happiness = hp'
happy = hp,
harbor = Hb
hard = h/
harden = h/n
hardly = h/l
hardware = h/wa
hark = hak
harm = hm
harmless = hml'
harmony = hmn,
harp = hap
harry = hy
harsh = hZ
harvest = hv,
has = as
has been = asb
has had = ash
hasn't = as-
haste = ha,
hasty = hs,
hat = ht
hate = ha
have = v
have been = vb
have been away = vbawa
have been here = vbhe
have had = vh
have not been = vnb
have you been = vub
haven = hvn
hawthorn = hthn
hay = ha
hazard = hz/
hazy = hz,
he = e
he can work = ekwk
he cannot = ekn
he found = befw
he has not been = easnb
he likes = elks
he must = em,
he was = ez
he will = el
he will be = elb
he would = ed
he would have = edv
he'd = ed
he'll = el
he's = es
head = hd
headquarters = hdQ//
heal = hel
health = hlt
healthy = hlt,
hear = he
heard = h/
hearer = He
hearing = heg
heart = h/
hearts = h//
heat = he
heater = He
heather = H
heavy = hv
hedge = hj
heel = hl
height = hi
heir = ar
heirloom = arlm
held = hl
hello = hlo
helmet = hlmt
help = hp
helpful = hpf
her = h
herb = hb
here = he
here now = henw
here's = hes
hereditary = hrdty
heresy = hes,
heritage = hetj
hermetic = hmT
hero = hro
herself = hs/
hesitate = hsta
hew = hu
hickory = hky
hidden = hdn
high = hi
higher = Hi
highjack = hijk
highway = hiwa
hill = hl
him = m
himself = ms/
hint = h-
hippopotamus = hptmx
hire = hi
his = s
his or her = sorh
his place = spl
his way = swa
hiss = h'
history = hS,
hit = ht
hoard = ho/
hoary = hy
hobby = hb,
hockey = hk,
hoe = ho
hog = hg
hold = hl
holder = Hl
holiday = hld
hollow = hlo
holographic = hlGk
home = ho
homeland = hol-
homeless = hol'
homeward = ho/
honest = on,
honesty = ons,
honey = hn,
honk = hq
honor = On
honorarium = Onym
hood = hd
hooray = hra
hope = hop
hopeful = hopf
hopeless = hopl'
horn = hrn
horoscope = hskp
horrible = hrb
horror = Hr
horse = hs
horseback = hsbk
horticulture = h/kl
hose = hz
hospital = hsptl
host = h,
hostage = hsj
hostility = hsl;
hot = ht
hotel = htl
hour = r
hourly = rl
house = hw
household = hwhl
how = hw
how many times = hwmti
how much = hwmc
however = hwv
huckleberry = hKby
huddle = hdl
hue = hu
hug = hg
huge = hj
hum = hm
human = hmn
humane = hman
humanism = hmnI
humanity = hmn;
humidity = hmd;
humiliation = hmlj
humor = Hm
humorours = Hmx
hundred = H
hundreds = Hs
hunger = Hg
hungry = Hg,
hunk = hq
hunt = h-
hunter = H-
hurray = hra
hurricane = hykn
hurry = hy
hurt = h/
hurtful = h/t
husband = hsb-
husk = hsk
hydrate = H;
hydrocarbon = Hkbn
hydrogen = Hjn
hydroxide = Hxi
hygiene = hjn
hyphen = hfn
hypnotic = hpnT
hypocrisy = hpks,
hysteria = hSa
I = i
I am doing = imdo
I do not think = idontq
I have had = ivh
I have worked = ivwk
I think = itq
I was surprised = izspz
I'd = id
I've = iv
ice = is
ideal = ide
idiotic = idT
if = if
if he = ife
if he can = ifek
if he was = ifez
if would like = ifudlk
if you = ifu
if you ever = ifuev
illegal = ilgl
illegitimate = iljma
illuminate = ilm;
image = ij
imaginative = ijnv
immediate = id;
impatient = ipj/
impeach = ipc
imperial = iPl
impervious = ipvx
imply = ipi
important = ip
impossible = ipsb
improper = iPp
in = n
in a day = nad
in each = nec
in every = nev
in everything = nevg
in his = ns
in his own = nson
in the = nt
in the city = nts;
in the end = nte-
in time = nti
in which = nwc
inaccessible = nxsb
incandescent = nk-s-
inch = nc
income = nk
incomplete = nkpe
incomprehensible = nkpcb
incontrovertible = nKv/b
incorrect = nkrk
indeed = ndd
independent = ndp--
indestructible = ndSkb
index = ndx
Indian = ndn
indicate = ndka
indicator = Ndka
indistinct = ndsq
individual = ndvd
indoors = ndos
industry = ndS
inexact = nxk
infer = nf
infinity = nfn;
inflammatory = nflmty
influence = nfu/
influenza = nfnza
information = nfj
initial = nix
initiate = nZ;
initiative = nZv
injure = nju
ink = iq
inmate = nma
inner = N
innocent = ins-
inquire = nqi
insert = ns/
inside = nsi
insist = ns,
inspect = nspk
instant = ns-
instantaneous = ns-x
instead = nsd
insulator = nsLa
insure = nsu
intelligence = Nj
intelligent = Nj
intense = ntc/
interest = N,
interfere = Nf
interim = Nm
intermission = Nmj
international = Nnjl
internet = Nnt
interplanetary = Nplnty
interpretation = Nptj
interrogate = Nga
intervene = Nvn
intestine = ntsn
into = nt
into his = nts
introduce = Ndu
introvert = Nv/
invade = nva
invent = nv-
inventory = nv-y
invest = nv,
investigation = nvsgj
invisible = nvsb
invite = nvi
invocation = nvkj
involve = nvl
inward = n/
iodine = idn
iota = iot
iron = io
irregular = irg
irritation = irtj
is = s
is like = slk
is near = sne
is not = sn
is simple = ssmp
is too = sto
is white = swi
iself = ts/
isn't = s-
isolate = isla
issue = isu
it = t
it is = ts
it is near = tsne
it is said = tssd
it must = tm,
it was = tz
it will = tl
it will be = tlb
it will not be = tlnb
it would have been = tdvb
it's = ts
its = ts
its love = tslv
ivory = ivy
ivy = iv,
jacket = jkt
jagged = jgd
jail = jl
January = ja
jar = ja
jasmine = jsmn
javelin = jvln
jaw = ja
jealous = jlx
jealousy = jlx,
jelly = jl,
jeopardy = jp/,
jersey = jrs,
job = jb
jog = jg
join = jy
joint = jy-
joke = jk
journal = jnl
journalism = jnlI
journey = jn,
joy = jy
joyful = jyf
jubilation = jblj
judge = jj
judgement = jj-
judging by this = jjbth
juice = js
July = jl
jump = jm
June = ju
jury = jy
just = j,
juvenile = jvnl
juxtaposition = jxpsj
kale = kal
kangaroo = kgu
keep = kp
keeper = Kp
keeping in mind = kpnmi-
keg = kg
kelp = klp
kernel = knl
kerosene = kse
ketchup = kcp
kettle = ktl
key = ke
keyboard = keb/
kick = kk
kidnap = kdnp
kidney = kdn,
kilogram = klG
kilometer = klMe
kimono = kmno
kind = ki
kinder = Ki
kindle = k-l
kindness = ki'
king = kg
kingdom = kgdm
kiss = k'
kitchen = kcn
kite = ki
knack = nk
knee = ne
knew = nu
knickerbocker = nkBk
knife = nf
knight = ni
knighthood = nihd
knit = nt
know = no
know all about it = nolabt
know it = not
know why = noy
knowing = nog
knowledge = nlj
knuckle = nK
kosher = KZ
labor = Lab
lack = lk
lady = ld,
lament = la-
lamp = lmp
land = l-
language = lg
lard = l/
large = lj
large number of = ljnov
larger = Lj
last = l,
last year = l,y
late = la
later = La
latitude = ltu
laugh = lf
launch = lnc
laundry = L-,
lava = lva
lavatory = lvty
lavender = Lv-
lavish = lvZ
law = la
lawful = laf
lawn = lan
lawyer = La
laxative = lxv
laxity = lx;
lay = la
layer = La
lazy = lz
leader = Le
leaf = lf
league = lg
leak = lk
leakage = lkj
learn = ln
learner = Ln
least = le,
leather = Le
leave = le
leave you = leu
leaves = les
lecture = lku
lecturer = Lku
ledger = Lj
leer = le
left = lf
left us = lfus
leg = lg
legal = lgl
legalize = lglz
legend = lj-
legibility = ljb;
legislate = ljla
legislature = ljlau
legitimate = ljma
lemon = lmn
lemonade = lmna
lend = l-
lender = L-
length = lng
lentil = l-l
leopard = lp/
less = l'
lesson = lsn
let = lt
let's = lts
letter = L
lettuce = lts
levee = lve
level = lvl
lever = Lv
leverage = Lvj
levity = lv;
lexicographer = lxGr
lexicon = lxk
liar = Li
liberty = Lb
library = lby
lice = lis
license = lsc/
lichen = lkn
lick = lk
licorice = Lks
lid = ld
lie = li
life = lf
lifetime = lfti
lift = lf
ligature = lgtu
light = li
lighter = Li
lightly = lil
lightning = ling
like = lk
like it = lkt
limestone = lmsto
limit = lmt
limp = lmp
line = li
linear = lne
liner = Li
lingerie = lZy
lingo = lgo
linguistic = lgS
lining = lig
link = lq
linoleum = lnlm
lint = l-
lion = lio
lip = lp
liquefy = lqf
liquid = lqd
liquor = Lk
list = l,
listen = lsn
listener = Lsn
literacy = Ls,
literature = Ltu
lithograph = ltG
litmus = ltmx
litter = L
little = ll
little by little = llll
little later = llLa
live = lv
liver = Lv
lives = lvs
lizard = lz/
load = lo
loan = ln
loathsome = lthso
lobster = lbS
local = lkl
location = lkj
locomotive = lkmv
locust = lk,
lodestone = losto
logic = ljk
lone = lon
lonely = lnl
lonesome = lnso
long = lg
long time ago = lgtiag
long way = lgwa
longhand = lgh-
longitude = ljtu
look = lo
loose = ls
loquacious = lqx
lord = l/
lose = lz
loser = Lz
loss = l'
lost = l,
lotus = ltx
loud = lw
lounge = lwj
love = lv
lovely = lvl
lover = Lv
low = lo
loyal = lyl
lubricate = lbka
lucid = lsd
luck = lk
lucky = lk,
lull = ll
lumber = Lmb
luminary = lmny
luminous = lmnx
lunar = Ln
lunch = lc
lung = lng
lunge = lj
lure = lu
lust = l,
luxurious = lxyx
luxury = lxy
lye = li
lying = lig
lynx = lnx
machine = mZ
mad = md
made = ma
madness = md'
magazine = mg
magic = mjk
magician = mjj
magnet = Mgt
magnify = Mgf
magnolia = Mgla
mail = ml
main = mn
major = Mj
majority = Mj;
make = mk
make good = mkg
maker = Mk
malaria = mlya
malicious = mlx
malpractice = mlpak
malware = mlwa
man = m-
manage = mnaj
manager = mgr
mandarin = m-rn
mandate = m-;
mandolin = m-ln
mania = mna
manner = Mn
manual = mnul
manufacture = mfr
manufacturer = Mfr
manure = mnu
many = m
many of the = mvt
many years ago = myag
march = mc
March = mc
margin = mjn
marigold = mygol
marjoram = mjrm
mark = mak
market = mkt
marmalade = mmla
marriage = myj
marry = my
marsh = mZ
mash = mZ
mask = msk
masonry = msnr,
masquerade = mskra
mass = m'
master = mS
masts = m,,
masturbate = mSba
match = mc
matter = Ma
matter of fact = Mafk
maximum = mx
may = ma
May = ma
may be = mab
may have been = mavb
mayor = Ma
me = me
meadow = mdo
mean = me
meant = m-
measure = mz/
meat = me
mechanical = mkK
meditation = mdtj
medley = mdl,
meet = me
mellow = mlo
member = Mb
memorize = mmrz
memory = mmy
men = mn
mend = m-
mental = m-l
mentor = M-
meow = mw
merchant = mc-
mercury = mky
merry = my
mesh = mZ
mess = m'
message = msj
met = mt
metal = mtl
meteor = Me
meteorology = Meol
mice = ms
microcosm = mkkO
middle = mdl
might = mi
might be = mib
might not be = minb
mighty = mi,
milestone = misto
military = mlty
milk = mlk
millennial = mlnl
miller = Ml
Million = M
millstone = mlsto
mimeograph = mmG
mince = mc/
mind = mi-
mindful = mi-f
mine = mi
miner = Mi
mineral = Mnl
minimize = mmz
minimum = mm
minister = mnS
minority = Mn;
minute = mn
miracle = mK
miraculous = mklx
mirror = Mr
miser = Mz
mishap = mshp
misinterpretation = msNptj
mislead = msle
mismanagement = msmnj-
miss = m'
missed = m,
mission = mj
mist = m,
mix = mx
mixer = Mx
model = mdl
modern = mdn
modify = mdf
moist = my,
moment = mo-
Monday = mn
money = mn,
monk = mq
monster = mnS
monstrous = mnSx
month = mo
monthly = mol
months of = mov
moon = mu
moonlight = muli
more = mo
more and more = momo
more or less = mol'
more than = mon
more time = moti
morning = mng
moss = m'
most = mo,
most of = mo,v
moth = mth
mother = Mo
motion = mj
mountain = mt
mouse = mws
move = mv
movement = mv-
Mr. = M
Mrs. = mrs
much = mc
much as = mcas
much more = mcmo
muffin = mfn
multiple = Mlp
multiply = Mlpi
multitude = Mltu
municipal = mnsp
murderer = Mrr
museum = mzm
music = msk
musical = msK
must = m,
must be = m,b
must have been = m,vb
mutual = muul
my = mi
my place = mipl
myself = mis/
mystery = mS,
mythical = mtK
mythology = mtol
name = na
narcotic = nkT
narrow = nro
nation = nj
national = njl
natural = Nal
nature = Na
near = ne
near the = net
nearly = nel
necessary = nec
need = ne
needle = nel
neighbor = Nb
neither = Ne
nest = n,
network = ntwk
never = nv
new = nu
new place = nupl
new thing = nutg
New York = NY
news = nz
next = nx
next day or two = nxd2
nice = ns
nickel = nK
night = ni
nightfall = nifa
nightly = nil
nitrogen = Nijn
no = no
no better than = noBn
no one else = nonls
no other = noO
nobility = nb;
noise = nys
noisy = nys,
none = nn
noodle = ndl
nor = nr
north = N
nose = nz
not = n
not many = nm
not only = nnl
notation = ntj
note = nt
nothing = ng
November = nv
now = nw
now and then = nwtn
number = no
number of times = novtis
nut = nt
nutrition = Nuj
nutritious = Nux
nymph = nmf
oak = ok
obey = oba
object = ob
observation = obsj
observe = obs
obtain = obtn
occasion = kjl
ocean = oj
October = oc
oddity = od;
of = v
of course = vks
of it = vt
of love = vlv
of one = von
of the = vt
of them = vtm
of us = vus
of you = vu
off = of
offensive = ofcv
office = ofs
officer = Ofs
official = ofx
often = of
oil = yl
old = ol
old man = olm-
older = Ol
omit = omt
on = o
on a = oa
one = on
one another = onaO
one of our = onvr
only = nl
only kind = nlki
open = op
opinion = opn
opponent = opn-
opportunity = opt
oppose = opz
opposite = opst
opposition = opsj
oppress = op'
optical = opK
option = opj
or = or
or both = orbo
or they = orty
orchestra = okSa
orchid = okd
order = Or
ordinary = ody
organization = ogj
original = ojnl
osprey = ospa
other = O
other than = On
others = Os
otherwise = Owz
ouch = ouc
ought = ot
our = r
our hearts = rh//
ours = rs
ourselves = rs//
oust = ou,
out = ou
out of = ouv
outbreak = oubk
outlandish = oul-Z
outside = ousi
over = V
over and over = VV
overcome = Vk
overdue = Vdu
overpower = Vpw
overturn = Vtn
overweight = Vwa
owe = o
owl = oul
own = on
owner = On
oxygen = xjn
oyster = yS
Pacific = psfk
package = pkj
page = pj
paint = pa-
painter = Pa-
palimpsest = plmps,
panel = pnl
pansy = pnz
panther = Pn
paper = Pp
papyrus = pprx
paradise = Pdi
paragraph = PG
parasite = Psi
parliament = prl-
part = p/
part of = p/v
part of it = p/vt
participate = p/spa
particle = p/K
partner = P/n
partridge = p/rj
party = p/,
pass = p'
passer = P'
past = p,
path = pth
pathological = ptolK
pathologist = ptol,
pathology = ptol
pause = pz
pay = pa
pea = pe
peculiar = Pkl
pelican = plkn
penalty = pnlt,
pending = p-g
pentagon = p-gn
people = pp
pepper = Pp
percentage = pcj
perfect = pfk
perhaps = pps
permanent = pm-
permission = pmj
peroxide = pxi
person = psn
persuade = psa
persuasion = psaj
pertain = ptn
pest = p,
petition = ptj
petroleum = Pelm
pharmacy = fms,
phoenix = fnx
phonograph = fnG
phonology = fnol
phosphorous = fsfx
photograph = ftG
phrase = frz
physicist = fss,
physics = fsks
piano = pno
pick = pk
pickle = pK
pie = pi
piece = pc
pillow = plo
pine = pi
pink = pq
pitcher = Pc
pity = p;
place = pl
placement = pl-
plain = pln
planet = plnt
planetarium = plntym
plant = pl-
platitude = pltu
play = pla
player = Pla
pleasant = pls-
please = pl
plenty = pl-,
plow = plw
plus = plx
poem = pom
point = py
policy = pls,
political = plK
pond = p-
ponder = P-
popcorn = ppkn
popular = pop
porcupine = pkpi
portion = pj
possible = psb
pound = pw
precise = pss
predict = pdk
preference = pfc/
prepare = ppa
prescription = pskpj
present = ps-
president = psd-
press = pr'
pretty = p;
price = ps
priest = pe,
primary = pmy
prime = pm
prince = pc/
princess = pc'
print = pr-
printer = Pr-
priority = Pi;
prism = pI
prison = psn
prisoner = Psn
privacy = pvs,
procedure = psdu
process = ps,
produce = pdu
professor = Pf'
progess = pg'
program = pG
promise = pms
propose = ppz
prosecute = prsku
prosperity = psp;
protest = pt,
protester = Pt,
protoplasm = ptpA
prove = pv
proverbial = pvbl
provide = pvi
province = pvc/
provisional = pvjl
proximity = px;
pseudonym = sdnm
pshaw = Za
psychology = skol
public = pb
pull = pu
pumpkin = pqn
punish = pnZ
purchase = pcs
pursue = psu
push = pZ
put = p
puzzle = pzl
pyrotechnics = Ptkks
python = pthn
quadrant = Q-
quadruple = Qp
quality = q;
quart = q/
quarter = Q/
queen = qn
queer = qe
query = qy
question = q
questionable = qb
quiet = qt
quintuple = q-p
quirky = qk,
quite = qi
quite a few = qifu
quite right = qiri
quiz = qz
quotation = qoj
quote = qo
rabbit = rbt
rabies = rb,,
race = rs
racer = Rs
radiate = rd;
radiation = rdj
radio = rdo
radioactive = rdoakv
raffle = rfl
rage = raj
railroad = rr
raiment = ra-
rain = rn
rainy = rn,
raise = rz
rampage = rmpj
ranch = rnc
rancour = Rq
random = r-m
rank = rq
rape = rap
rapid = rpd
rapidly = rpdl
rarely = ral
rarity = ra;
rash = rZ
raspberry = rsby
rather = Ra
rather than = Ran
ratify = rtf
rational = rjl
ray = ra
razor = Rz
reach = rc
react = rak
reaction = rakj
reactor = Rak
read (infinitive) = re
read (past tense) = rd
reader = Re
readily = rdl
ready = rd,
realization = rlzj
realize = rlz
really = rl
reason = rsn
reasonable = rsnb
rebate = rba
rebuke = rbu
recall = rkl
receive = rse
receiver = Rse
recent = rs-
recently = rs-l
receptive = rspv
recite = rsi
reckless = rkl'
recognition = rjk
recommend = rk-
reconsider = rKs
record = rk/
recover = rKv
recreation = rkrj
recurring = rkrg
red = rd
redemption = rdmj
reduce = rdu
reduction = rdkj
reelect = rlk
refer = rf
referendum = fr-m
refinery = rfiy
reflect = rfk
reflection = rfkj
reflector = Rfk
refrigerator = Rfj;
refugee = rfje
refuse = rfz
refute = rfu
regard = rg/
region = rjn
registrar = rjSr
registration = rjSj
regulate = rg;
regulation = rgj
regulator = Rg;
reject = rjk
rejoice = rjy
relation = rlj
release = rls
relieve = rle
reluctant = rlk-
remain = rmn
remember = Rmb
remove = rmv
rents = r--
repair = rpa
repeal = rpl
reply = rpi
report = rp/
reporter = Rp/
representative = rep
republican = rpbn
request = rq,
require = rqi
rescue = rsku
research = rsc
resident = rsd-
resist = rs,
resistance = rssc/
resolution = rslj
resource = rss
respect = rsp
respectable = rspb
respectful = rspf
respond = rsp-
response = rspc/
responsive = rspcv
rest = r,
restore = rS
result = rsl
resume = rsu
retina = rtna
retrieve = Rv
return = rtn
reverse = rvs
rhubarb = rubb
rich = rc
ride = rd
right = ri
ring = rg
rink = rq
rise = rz
river = Rv
road = rd
rock = rk
rocket = rkt
rooster = Ru,
rose = rz
rough = rf
round = rw
royal = ryl
rub = rb
rubber = Rb
ruby = rb,
run = rn
run-away = rnawa
runner = Rn
rushing = rZg
rushlight = rZli
sack = sk
sacred = Skd
sacrifice = Skfs
sad = sd
safe = sf
safely = sfl
safety = sf,
said = sd
sail = sal
sailboat = slbo
sailor = Sal
salad = sld
salary = sly
sale = sal
saliva = slva
salmon = smn
salt = slt
salute = slu
same = sa
sample = smp
sanctify = sqf
sanction = sqj
sanctuary = sqy
sand = s-
sandwich = s-wc
sanitarium = sntym
sanitary = snty
sarcasm = skA
satellite = stli
satire = sti
satisfactory = sat
saturate = stu;
Saturday = st
sauce = sas
saucer = Ss
save = sav
savior = Sv
saw = sa
sawmill = saml
saxophone = sxfn
say = sa
says = ss
scale = skl
scan = skn
scandal = sk-l
scapegoat = skpgo
scar = ska
scare = ska
scarecrow = skakro
scathing = skatg
scatter = Ska
scene = se
scent = s-
sceptical = skpK
schedule = skdu
scheme = skm
schism = sI
scholar = Skl
scholarship = SklZ
school = skl
science = si/
scientific = s-fk
scion = sio
scissors = Szs
scope = skp
score = sko
scotch = skc
scout = skw
scratch = skrc
scream = skrm
screen = skre
screw = skru
script = skpt
scripture = skpu
scropion = skpn
scrutiny = sktn,
sculpture = sklpu
scurrilous = sklx
scythe = sith
sea = se
seal = sel
search = sc
seashore = sZo
seaside = ssi
season = ssn
seat = set
seclusion = sklj
second = 2d
secondary = sk-y
secret = Skt
secretary = sec
section = skj
secure = sku
security = sku;
seduce = sdu
see = se
see her = seh
see me = seme
see only = senl
see you = seu
seeing = seg
seek = sek
seem = sm
seemingly = smgl
sees = sz
seize = sz
sell = sl
seller = Sl
senate = sn;
senator = Sn;
send = s-
sender = S-
sense = sc/
sensible = scb
sensitive = scv
sentence = s-c/
sentiment = s--
separate = sp;
September = sp
serious = syx
serve = sv
server = Sv
settler = Stl
sew = so
sewage = suj
sex = sx
sexual = sxl
sexy = sx,
shade = Za
shadow = Zdo
shake = Zk
shaker = Zkr
shall = Z
she = Z
she is = Zs
shelter = Zltr
shepherd = Zp/
shine = Zi
ship = Z
shipwreck = Zrk
shirt = Z/
shoe = Zu
shoes = Zz
shooter = Zur
shop = Zp
short = Z
shorthand = Z-
should = Zd
should go = Zdg
should go home = Zdgho
shovel = Zvl
show = Zo
shower = Zw
shy = Zi
side = si
sidereal = siyl
sight = si
sign = sin
significant = Sgfk-
similar = Sml
simple = smp
since = sc/
sing = sg
single = sgl
sink = sq
sister = sS
skirt = sk/
skunk = skq
sky = ski
sleep = slp
sleepy = slp,
slow = slo
small = sm
smaller = Sm
smile = smi
smooth = smu
sneeze = snz
snow = sno
so = so
so few = sofu
so much = somc
soap = sop
social = sox
soil = syl
solar = Sol
solarium = Solym
sold = sol
soldier = soj
solitude = sltu
solve = slv
some = so
some get = sogt
some men = somn
some of my = sovmi
some of the = sovt
some will = sol
somehow = sw
something = sg
sometimes = stis
somewhere = sr
soon = sn
sooner = Sn
sorcery = ssy
sorrow = sro
soul = sol
sound = sw
soup = sup
source = ss
south = S
sovereignty = sv-,
space = sps
spaghetti = spgt,
sparrow = spro
spasm = spA
speak = spe
speaker = Spe
special = spx
speech = spc
speed = spd
Speedwriting = spdrig
spend = sp-
sphere = sfe
spider = Spi
spinach = spnc
spoke = spo
sport = sp/
spring = spg
spy = spi
staff = stf
stair = sta
stand = st-
star = S
stark = Sk
starlight = Sli
start = St
statement = sta-
static = stT
station = stj
statistics = sttSs
status = stax
stay = sta
steady = std,
stenography = stnG,
step = stp
stigmata = stgmta
still = stl
stillness = stl'
sting = stg
stink = stq
stir = S
stock = stk
stone = sto
stood = std
store = S
storm = Sm
story = S,
straight = Sa
strange = Sj
strawberry = Saby
street = st
strike = Si
stroke = So
student = std-
study = std,
subject = sj
submarine = smrn
subscription = sskpj
substantial = sstx
succeed = suc
such = sc
such work = scwk
suck = sk
sudden = sdn
sufficient = sfj/
sugar = Sg
suggest = sj,
suggestion = sjsj
summary = smy
summer = Sm
sun = sn
Sunday = sn
sunflower = snflw
sunlight = snli
sunny = sn,
superficial = spfx
supernatural = spNal
supervisor = spVz
support = sp/
supreme = spm
sure = su
surprise = spz
surround = srw
survey = sva
survive = svv
suspension = sspnj
suspicion = sspj
sustain = sstn
sweet = swe
switch = swc
sycamore = skmo
symbolic = smbk
synchronous = sqrnx
system = ssm
systems = ssms
table = tab
tablespoon = tbspn
tackle = tK
tact = tk
tactical = tkK
tactics = tkks
tag = tg
tail = tal
tailor = Tal
take = tk
tale = tal
talent = tl-
talk = tak
tall = tl
tame = tam
tanager = Tnj
tangent = tj-
tangible = tjb
tank = tq
tap = tp
tape = tap
taper = Tap
tar = ta
tarantula = tr-la
tardy = t/,
target = tgt
tariff = trf
task = tsk
taste = ta,
tasty = tas,
taught = tat
tax = tx
taxicab = txkb
tea = te
teach = tc
teacher = Tc
teak = tek
teakettle = tktl
teal = tel
team = tem
tearful = tef
tease = tz
teaspoon = tspn
technical = tkK
technology = tkol
teem = tem
teen = ten
teenager = Tnaj
telegram = tlG
telepathy = tlpt,
telephone = tlfn
telescope = tlskp
television = tlvj
tell = tl
tell them = tltm
tell you more = tlumo
teller = Tl
temperature = tptu
temporarily = tpyl
temporary = tpy
tempt = tmt
temptation = tmtj
tend = t-
tendency = t-c/
tender = T-
tendon = t-n
tennis = tns
tense = tc/
tension = tnj
tent = t-
tenuous = tnux
tenure = tnu
term = tm
terminal = tml
termination = tmj
terminology = tmol
terrestrial = trSl
terrible = tyb
terrific = tyfk
terrify = tyf
territory = tyty
terror = Tr
terrorist = Tr,
test = t,
testament = ts-
testify = tsf
testimony = tsmn,
tetanus = ttnx
text = tx
texture = txu
than = n
than others = nOs
thank = tq
thankful = tqf
thanksgiving = tqsgi
that = ta
that they = taty
that will = tal
that will be = talb
the = t
the answer = tans
the best = tb,
the same = tsa
the usual = tx
the years = tys
thee = te
their = tr
their heads = trhds
their own = tron
their own way = tronwa
their work = trwk
them = tm
then = tn
theoretical = tyTl
theory = ty
there = tr
there are = trr
there is = trs
thereby = trb
therefore = trf
thermometer = tmMe
thesaurus = tsarx
these = tz
they = ty
they both = tybo
they both said = tybosd
they can = tyk
they could not = tykdn
they do not = tydon
they had = tyh
they have = tyv
they have been = tyvb
they like = tylk
they may = tyma
they said = tysd
they will = tyl
they will know = tylno
they would = tyd
they would do = tyddo
they'll = tyl
they're = tyr
they've = tyv
thick = tk
thickness = tk'
thief = tef
thigh = ti
thin = tn
thine = thi
thing = tg
things = tgs
think = tq
thinker = Tq
thinking = tqg
third = 3d
thirsty = ths,
this = th
this is how = thshw
this time = thti
this work = thwk
thorough = tro
those = tos
thou = tw
though = tho
thought = tt
thoughtful = ttf
thoughtless = ttl'
thousand = T
thousands = Ts
thread = trd
threat = trt
threaten = trtn
threatening = trtng
three = tre
threshold = trZl
threw = tu
thrifty = trf,
throat = trot
through = tu
through the = tut
throughout = tuw
throw = tro
thumb = tm
thunder = T-
thunderstorm = T-stm
Thursday = th
thus = tus
thusly = tusl
thy = ti
tick = tk
ticket = tkt
tickle = tK
tide = ti
tie = ti
tiger = Tg
tight = ti
tighten = tin
tile = til
till = tl
tiller = Tl
tilt = tlt
timber = Tmb
time = ti
timely = til
times = tis
timid = tmd
timothy = tmt,
tin = tn
tincture = tqtu
tinder = Tn
tine = tin
tinker = Tq
tiny = tn,
tip = tp
tirade = tira
tire = ti
tiresome = tiso
tissue = tsu
title = ttl
to = to
to do = tdo
to do it = tdot
to each = toec
to each one = toecon
to go = tg
to him = tom
to live = tlv
to our = tor
to pass = tp'
to pity = tp;
to say = tsa
to see it = tset
to the = tot
to type = ttp
to work = twk
to you = tu
toast = to,
tobacco = tbko
today = tod
toe = to
together = tog
toil = tyl
toilet = tylt
told = to
tolerant = Tl-
tolerate = Tl;
tomato = tmto
tombstone = tmsto
tomorrow = tom
tongue = tng
tonight = ton
tonsil = tcl
too = to
too soon = tosn
took = tk
tool = tul
tooth = tut
toothpick = ttpk
top = tp
topic = tpk
topical = tpK
topographic = tpGk
torch = toc
tore = to
torment = to-
tormentor = To-
torn = ton
tornado = tndo
torpedo = tpdo
torrent = tr-
tortoise = t/s
torture = t/u
toss = t'
total = ttl
totality = ttl;
totally = ttl
touch = tc
tough = tf
tour = tu
tourist = tu,
tournament = tn-
toward = t/
towel = twl
tower = Tw
town = tw
toxic = txk
toxicology = txkol
toy = ty
trace = trs
track = trk
traction = trkj
tractor = Trk
trade = tra
tradesman = trasm-
tradition = tdj
traditional = tdjl
traffic = tfk
tragedy = tjd,
trail = trl
train = trn
trainer = Trn
trait = tra
traitor = Tra
trajectory = tjky
tranquil = tql
transaction = Tkj
transcendental = Te--l
transcript = Tkp
transcription = Tkpj
transfer = Tf
transform = Tfm
transformer = TFm
transfusion = Tfj
transgender = TJ-
transit = Tt
translate = Tla
transmission = Tmj
transmit = Tmt
transparent = TP-
transplant = Tpl-
transport = Tp/
transportation = Tp/j
trap = trp
trascribe = Tkb
trash = trZ
trasmissible = Tmsb
travel = tvl
traveler = Tvl
tray = tra
treacery = tcy
treadmill = tdml
treason = tsn
treasure = tz/
treasurer = Tz/
treasury = tsy
treat = tre
treatment = tre-
treaty = tre,
tree = tre
tremble = trmb
tremendous = tm-x
tremor = Trm
trend = tr-
trial = tril
triangle = tragl
tribe = trb
trible = trbl
tribunal = tbnl
tribune = tbu
tribute = tbu
trick = trk
tries = trz
trigger = Trg
trigonometry = tgMe
trim = trm
trinity = trn;
trip = trp
triple = trp
trite = tri
triumph = trmf
troll = trl
troops = trps
tropical = trpK
trouble = trb
troublesome = tbso
trousers = Twss
trout = trw
trowel = trwl
troy = try
truce = tus
truck = trk
true = tu
trump = trmp
truncate = tnka
trunk = trq
trust = tr,
trustworthy = tswrt,
try = tri
tube = tb
tuberculosis = tbKss
tuck = tk
Tuesday = ts
tulip = tlp
tumor = Tm
tune = tu
tunnel = tnl
turbulence = tbc/
turkey = tk,
turmoil = tmyl
turn = tn
turnover = tnV
turnpike = tnpi
turnstile = tnsti
turquoise = tky
turtle = t/l
tweed = twe
twilight = twli
twin = twn
twine = twi
twinkle = twql
twist = tw,
twitter = Twt
type = tp
typewriter = tpRi
typhoon = tfu
typical = tpK
typography = tpG,
tyrant = tir-
ubiquitous = ubqx
ugly = ugl
ultimate = ulma
umbrella = mbla
umpire = mpi
unable = ub
unanimous = uamx
uncertain = us/n
unchanged = ucj
uncle = uql
uncomfortable = ukf/
uncover = uKv
under = U
under the circumstances = UtC,,
undergo = Ug
undermine = Umi
understand = Us-
understood = Usd
undertake = Utk
underwear = Uwa
underwent = uw-
undo = udo
unemployment = umpy-
unexpected = uxpk
unfair = ufa
unfamiliar = uFml
unfold = ufol
unfortunate = uf/na
unfounded = ufw
unhappy = uhp,
uniform = ufm
unilateral = uLal
union = un
unique = uek
unite = uni
unity = u;
universe = uvs
university = uvs;
unknown = uno
unlawful = ulaf
unless = ul'
unlike = ulk
unpleasant = upls-
unprecedented = upsd-
unsuitable = usub
until = ut
unusual = ux
unwittingly = uwtg
up = p
up and down = padw
up there = ptr
up to date = ptoda
uphold = pho
upon = pn
upper = P
upset = pst
upstairs = pstas
urban = ubn
urge = uj
urgent = uj-
us = us
use = us
use your head = usuhd
useful = usf
useless = usl'
utilitarianism = utltyI
utility = ut;
utilize = utz
utmost = utmo,
utterly = Utl
vacancy = vkc/
vacant = vk-
vacate = vka
vacation = vka
vaccination = vxnj
vaccine = vxn
vacuous = vkx
vacuum = vkm
vague = vag
valedictory = vldky
valerian = vlyn
valid = vld
validity = vld;
valley = vl
valuable = vlb
value = vlu
vampire = vpi
vane = vn
vanilla = vnla
vanish = vnZ
vapor = Vp
variable = vb
variety = vr;
various = vx
vary = v
vast = v,
veer = ve
vegetable = vjb
vegetarian = vjy
vehement = vh-
vehicle = vK
vein = vn
velocity = vls;
vendor = V-
veneer = vne
vengeance = vj/
vent = v-
ventilation = v-lj
venture = v-u
veranda = vr-a
verbatim = vbtm
verdant = v/-
verdict = v/k
verge = vj
verify = vf
vermicelli = vmsl
vernal = vnl
versatile = vstl
verse = vs
version = vj
versus = vs
vertical = v/K
very = v
very good = vg
very little = vll
very much = vmc
vessel = vsl
vest = v,
veteran = Vtn
veto = vto
vibrate = Vb;
vibration = Vbj
vice = vs
vice versa = vsvs
vicinity = vsn;
vicious = vx
victim = vkm
victor = Vk
victorious = Vkx
victory = Vk,
view = vu
vigil = vjl
vigorous = Vgx
village = vlj
villain = vln
vindictive = v-kv
vine = vin
vinegar = Vng
vintage = v-j
violate = vila
violation = vilj
violent = vil-
viper = Vp
virtual = vtul
virtue = vtu
virtuoso = vtuso
virtuous = vtx
virulent = vul-
virus = vrx
visible = vsb
vision = vj
visit = vst
visitor = Vst
visual = vx
vital = vtl
vitamin = vtm
vivid = vvd
vixen = vxn
vocal = vK
vociferous = vsfx
voice = vy
volcano = vlko
volley = vl,
volume = vol
voluntary = vl-y
volunteer = vl-e
vomit = vmt
vote = vo
voter = Vo
vow = vw
voyage = vyj
vulgar = Vlg
vulgarity = vlg;
vulnerable = vlnb
vulture = vltu
wage = wj
wagon = wgn
wail = wal
waist = w,
wait = wa
waiter = Wa
waitress = Wa'
wake = wak
walk = wak
walker = Wak
wall = wal
walnut = wlnt
walrus = wlrx
wand = w-
wander = W-
wanderer = W-r
want = w-
wanted = w-d
war = wr
warden = w/n
warehouse = wahw
warm = wm
warn = wn
warning = wng
warrior = Wr
was = z
was not = zn
wash = wZ
washer = WZ
wasn't = z-
waste = w,
watch = wc
water = Wa
waterfall = Wafa
watermelon = waml
wave = wv
wax = wx
waxy = wx,
way = wa
wayside = wasi
wayward = wa/
we = w
we are = wr
we could = wkd
we do not = wdon
we have been = wvb
we have no = wvno
we know = wno
we must have = wm,v
we will = wl
we will do = wldo
we will make = wlmk
we would = wd
we'd = wd
we're = wr
we've = wv
weak = wk
weakness = wk'
wealthy = wlt,
weapon = wpn
wear = wa
weary = wy
weather = W
weave = wv
web = wb
website = wbsi
Wednesday = wd
weed = we
week = wk
weekly = wkl
weigh = wa
weight = wa
weird = w/
weld = wld
welfare = wlfa
well = l
well-known = wlno
went = w-
were = w
west = W
western = Wn
wet = wt
whale = wal
what = wa
what do you = wadou
what is right = wasri
what would = wad
what you give = waugi
whatever = wav
whatever it is = wavts
wheat = we
wheel = wel
when = wn
when will you = wnlu
when you = wnu
when you come = wnuk
when you go = wnug
when you have = wnuv
whenever = wnv
where = wr
where is the = wrst
where we are = wrwr
whether = W
whether or not = Wn
which = wc
which he = wce
which one = wcon
which we are = wcwr
while = wl
while ago = wlag
whine = win
whip = wp
whirlpool = wlpu
whisky = wsk,
whisper = Wsp
white = wi
whiter = Wi
whittle = wtl
who = ho
who can = hok
who do = hodo
who do not = hodon
who have been = hovb
who said = hosd
who will = hol
who will give you = holgiu
who would = hod
who would like = hodlk
whoever = hov
whole = hl
wholesale = hlsl
wholesome = hlso
whom = hm
whore = ho
whose = hz
why = y
why do = ydo
wide = wd
widely = wdl
widow = wdo
width = wdt
wife = wf
wild = wil
wildly = will
will (n.) = wl
will = l
will also = llso
will be well = lbl
will come = lk
will come back = lkbk
will give = lgi
will know = lno
will see = lse
will see you = lseu
will you = lu
will you come = luk
will you come out = lukou
will you do = ludo
will you do it = ludot
will you go on = lugo
willow = wlo
win = wn
wind = wi-
windmill = w-ml
window = w-o
windy = w-,
wine = win
wing = wg
winner = Wn
winter = W-
wire = wi
wisdom = wsdm
wise = wz
wise choice = wzcys
wisely = wzl
wish = wZ
wishful = wZf
witch = wc
with = w
with a = wa
with her = wh
with me = wme
with my = wmi
with their = wtr
with you = wu
with you now = wunw
withdraw = wda
withdrew = wdu
within = wn
without = ww
witness = wt'
wizard = wz/
woe = wo
wolf = wlf
wolves = wlvs
woman = wm
women = wmn
won = wn
won't = wo-
wonder = W-
wonderful = W-f
wood = wd
wooden = wdn
woodlands = wdl-s
woodpecker = wdPk
word = w/
wore = wo
work = wk
work well = wkl
worker = Wk
workmanship = wkmnZ
world = wo
worldwide = wowd
worm = wm
worn = won
worry = wy
worse = ws
worse than = wsn
worst = w,
worth = wrt
worthless = wrtl'
would = d
would have = dv
would not = dn
would not let = dnlt
would you be able = dubab
wouldn't = d-
wrangle = rgl
wreath = ret
wreck = rk
wrench = rnc
wrestle = rsl
wretched = rcd
wrinkle = rql
wrist = r,
write = ri
writer = Ri
writing = rig
written = rtn
wrong = rg
wrote = ro
wry = ri
wryly = ril
x-ray = xra
xylophone = zlfn
Yankee = yqe
yard = y/
year = y
year after year = yafy
year or two ago = y2ag
yearly = yl
yeast = y,
yellow = ylo
yesterday = ySd
yet = yt
yield = yl
yonder = Y-
you = u
you and I = uai
you are not = urn
you can = uk
you can do = ukdo
you do = udo
you do it = udot
you ever = uev
you go = ug
you go out = ugou
you have been = uvb
you have had = uvh
you know = uno
you like = ulk
you shall = uZ
you should = uZd
you still = ustl
you think = utq
you will = ul
you will come = ulk
you will probably = ulpb
you'd = ud
you're = ur
you've = uv
young = yg
younger = Yg
youngster = ygS
your = u
yours truly = ut
yourself = us/
yourselves = us//
zenith = znt
zero = zro
zinc = zq
zodiac = zdk
zoning laws = znglas
zoo = zu
zoology = zol
zounds = zw--
<end>